5,5,5,5,5,5,5,5,5,5,5,5,5,5,5,5
5,5,5,5,5,5,5,5,5,5,5,5,5,5,5,5
5,5,5,5,5,5,5,6,6,5,5,5,5,5,5,5
5,5,5,5,5,5,6,0,0,6,5,5,5,5,5,5
5,5,5,5,5,6,0,0,0,0,6,5,5,5,5,5
5,5,5,5,5,6,0,0,0,0,6,5,5,5,5,5
5,5,5,5,6,0,0,0,0,0,0,6,5,5,5,5
5,5,5,6,0,0,0,0,0,0,0,0,6,5,5,5
5,5,6,0,0,0,0,0,0,0,0,0,0,6,5,5
5,5,6,4,4,4,4,4,4,4,4,4,4,6,5,5
5,6,0,0,0,0,0,0,0,0,0,0,0,0,6,5
5,6,6,6,6,6,6,6,6,6,6,6,6,6,6,5
5,5,5,6,6,6,6,6,6,6,6,6,6,5,5,5
5,5,5,5,6,6,6,6,6,6,6,6,5,5,5,5
5,5,5,5,5,6,6,6,6,6,6,5,5,5,5,5
5,5,5,5,5,5,6,6,6,6,5,5,5,5,5,5